1111111111111
10000000000C1
1001110CCCC01
1P00CE0000001
1111111111111
